{
    "Name":"Map1",
    "Level":1,
    "Start_pos": [8,1],
    "Goal_pos": [1,18],
    "Layout":[
        [1,1,1,1,1,1,1,1,1,1,1,1,1,1,1,1,1,1,1,1],
        [1,0,0,0,0,0,1,0,0,0,0,0,0,0,0,0,0,1,3,1],
        [1,0,4,0,0,0,1,0,0,0,0,0,0,0,0,0,0,1,0,1],
        [1,0,0,0,0,0,1,0,0,0,0,0,0,0,0,0,0,1,0,1],
        [1,0,0,0,0,0,5,0,0,0,0,0,0,0,0,0,0,0,0,1],
        [1,0,0,0,0,0,5,0,0,0,0,0,0,0,0,0,0,0,0,1],
        [1,0,0,0,0,0,1,0,0,0,0,0,0,0,0,0,0,0,0,1],
        [1,0,0,0,0,0,1,0,0,0,0,0,0,0,0,0,0,0,0,1],
        [1,2,0,0,0,4,1,0,0,0,0,0,7,0,0,8,0,0,0,1],
        [1,1,1,1,1,1,1,1,1,1,1,1,1,1,1,1,1,1,1,1]
    ]
}